0,0,0,0,0,0,0,0,0,0,0,0,0,0,0,0
0,1,2,3,0,0,1,2,2,2,2,2,2,2,3,0
0,4,0,4,0,0,4,0,0,0,0,0,0,0,4,0
0,4,0,4,0,0,9,2,3,0,0,0,0,0,4,0
0,4,0,9,2,2,2,2,10,0,0,0,0,0,4,0
0,4,0,0,0,0,0,0,0,0,1,2,3,0,4,0
0,4,0,0,0,0,0,0,0,0,4,0,9,2,10,0
0,4,0,1,2,2,2,16,2,2,10,0,0,0,0,0
0,9,2,10,0,0,0,0,0,0,0,0,0,0,0,0
0,0,0,0,0,0,0,0,0,0,0,0,0,0,0,0
