****************
****************
***F========7***
***|********|***
***|********|***
***|********|***
***|********|***
***L========U***
****************
****************
10
12
15